_______________________________________________________________________________
_=============================================================================_
_=============================================================================_
_=============================================================================_
_=============================================================================_
_=============================================================================_
_=============================================================================_
_=============================================================================_
_=============================================================================_
_=============================================================================_
_=============================================================================_
_==================================================================__=========_
_===========================================================__================_
_=============================================================================_
_====================================================__=======================_
_=================================_====_===_=====_============================_
_=============================================================================_
_====================__=====_===========================================_=====_
_=============================================================================_
_=========_===================================================================_
_______________________________________________________________________________